map "map01" {
	author "Ankh";
	version "1.0";
	description "Demo map";

	global-scripts [
		"scripts/map-scripts/map01/alert01"
	];

	layers {
		layer "ground" {
			tiled;
			shortcut 1 "grass";
			shortcut 2 "beach";
			shortcut 3 "shallow";
			grid-data [
				// 32 tiles wide
				"111111111111111111111111111111111111111232111111",
				"111111111111111111111111111111111111111232111111",
				"111111111111111111111111111111111111111232111111",
				"111111111111111111111111111111111111111232111111",
				"111111111111111111111111111111111111111232111111",
				"111111111111111111111111111111111111111232111111",
				"111111111111111111111111111111111111111232111111",
				"111111111111111111111111111111111111111232111111",
				"111111111111111111111111111111111111111232111111",
				"111111111111111111111111111111111111111232111111",
				"111111111111111111111111111111111111111232111111",
				"111111111111111111111111111111111111111232111111",
				"111111111111111111111111111111111111111232111111",
				"111111111111111111111111111111111111111232111111",
				"111111111111111111111111111111111111111232111111",
				"111111111111111111111111111111111111111232111111",
				"111111111111111111111111111111111111111232111111",
				"111111111111111111111111111111111111111232111111",
				"111111111111111111111111111111111111111232111111",
				"111111111111111111111111111111111111112232111111",
				"111111111111111111111111111111111111112232111111",
				"111111111111111111111111111111111112222321111111",
				"111111111111111111111111111111111222233211111111",
				"111111111111111111111111111111111122332111111111",
				"111111111111111111111111111111111123221111111112",
				"111111111111111111111111111111111122111111111123",
				"111111111111111111111111111111111211111111111233",
				"111111111111111111111111111111111111111111111123",
				"222111111111111111111111111111111111111111111123",
				"112221111111111111111111111111111111111111111233",
				"111121111111111111111111111111111111111111112333",
				"111112111111111111111111111111111111111111112333",
				"111111111111111111111111111111111111111111122333",
				"111111111111111111111111111111111111111111122333",
				"111111111111111111111111111111111111111111122333",
				"111111111111111111111111111111111111111111122333",
				"111111111111111111111111111111111111111111122333",
				"111111111111111111111111111111111111111111122333",
				"111111111111111111111111111111111111111111122333",
				"111111111111111111111111111111111111111111122333",
				"111111111111111111111111111111111111111111122333",
				"111111111111111111111111111111111111111111122333",
				"111111111111111111111111111111111111111111122333",
				"111111111111111111111111111111111111111111122333",
				"111111111111111111111111111111111111111111122333",
				"111111111111111111111111111111111111111111122333",
				"111111111111111111111111111111111111111111122333",
				"111111111111111111111111111111111111111111122333",
				"111111111111111111111111111111111111111111122333",
				"111111111111111111111111111111111111111111122333",
				"111111111111111111111111111111111111111111122333"
				// 32 tiles high
			];
		}
		layer "environment" {
			shortcut 1 "tree1";
			shortcut 2 "tree2";
			shortcut 3 "tree3";
			shortcut 4 "tree4";
			shortcut 5 "tree5";
			shortcut 8 "tree6";
			shortcut 9 "tree7";
			shortcut 10 "tree8";
			shortcut 6 "stone";
			shortcut 7 "rock";
			object-data {
				1 [
					[-3, -2]
				];
				2 [
					[-6, -2],
					[-5, -2],
					[-2, -2]
				];
				3 [
					[-4, -4]
				];
				4 [
					[-4, -3]
				];
				5 [
					[-4, -2]
				];
				8 [
					[-4, -1]
				];
				9 [
					[-4, 0]
				];
				10 [
				  [1, -2],
				  [-1, 2]
				];
			}
		}
		layer "buildings" {
			shortcut 1 "village";
			shortcut 2 "storage";
			object-data {
				1 [[0, 0]];
				2 [[5, 1]];
			}
		}
		layer "misc" {
			shortcut 1 "spawn-point" [
				["logic", "misc/spawn-points/wild-animals-common"],
				["animal", "deer"]
				];
			shortcut 2 "spawn-point" [
				["logic", "misc/spawn-points/wild-animals-common"],
				["animal", "rabbit"]
				];
			shortcut 3 "spawn-point" [
				["logic", "misc/spawn-points/wild-animals-common"],
				["animal", "bear"]
				];
			object-data {
				1 [[-12, 0], [14, 14]];
				2 [[-9, 12]];
				3 [[15, -8]];
			}
		}
	}
}